0000300000300000
0070000080000000
0000000000000060
0800000000000000
4000005000700004
0000000000000000
0000060000005000
0007000560000000
0000000870000000
0006000000000070
0000000060000004
0800000000000800
0000007000000000
4000000000500000
0050000000000000
0000030000040000
