0000300000300000
0070000080000000
0000000000000060
0800000000000000
4000005000700004
0000000000000000
0000060000005000
0007000500000000
0000000000000000
0000000000000000
0000000000000000
0000000000000000
0000000000000000
0000000000000000
0000000000000000
0000000000000000
